------------------------------
-                            -
-                            -
-               o            -
-              ---           -
------------------------------