------------------------------------------------
-                                              -
-                                              -
-                                              -
-                                              -
-                                              -
-                                              -
-                                              -
-                                              -
-                                              -
-                                              -
-                                              -
-                                              -
-                                              -
-                                              -
-                                              -
-                                              -
-                                              -
-                                              -
-                                              -
-                                              -
-                                              -
-                                              -
-                                              -
-                                              -
-                                              -
-                                              -
-                                              -
-                                              -
-                                              -
-                                              -
-                                              -
-                                              -
-                                              -
-                                              -
-                                              -
-                                              -
-               o                              -
-              ^^^    o                        -
------------------------------------------------