------------------------------------------------
-                                              -
-                                              -
-                                              -
-                                              -
-                                              -
-                                              -
-                                              -
-                                              -
-                                              -
-                                              -
-                                              -
-                                              -
-                                              -
-                                              -
-                                              -
-                                              -
-                                              -
-                                              -
-                                              -
-                                              -
-                                              -
-                                              -
-                                              -
-                                              -
-                                              -
-                                              -
-                                              -
-                                              -
-                                              -
-                                              -
-                                              -
-                                              -
-                                              -
-                                              -
-                                              -
-                                              -
-               o                              -
-              ---    o                        -
------------------------------------------------