------------------------------
-                            -
-                            -
-               o            -
-              ---    o      -
------------------------------