------------------------------
-                            -
-                            -
-               oo           -
-              ----          -
------------------------------